#########
#h      #
# #### ##
#   ##  #
### ## ##
#       p
#########