#############################
# h                         #
#                           #
####################### #####
#                           #
#### ############## #########
#                          p#
#############################